{
	"name": "Mysterious Forest North",
	"startX": 640,
	"startY": 1216,
	"startFacing": "up",
	"width": 1280,
	"height": 1280,
	"columns": 20,
	"rows": 20,
	"background": [
		[   1,   1,   1,   1,   1,   1,   1,   1,   1,   1,   1,   1,   1,   1,   1,   1,   1,   1,   1,   1],
		[   1,   1,   1,   1,   1,   1,   1,   1,   1,   1,   1,   1,   1,   1,   1,   1,   1,   1,   1,   1],
		[   1,   1,   1,   1,   1,   1,   1,   1,   1,   1,   1,   1,   1,   1,   1,   1,   1,   1,   1,   1],
		[   1,   1,   1,   1,   1,   1,   1,   1,   1,   1,   1,   1,   1,   1,   1,   1,   1,   1,   1,   1],
		[   1,   1,   1,   1,   1,   1,   1,   1,   1,   1,   1,   1,   1,   1,   1,   1,   1,   1,   1,   1],
		[   1,   1,   1,   1,   1,   1,   1,   1,   1,   1,   1,   1,   1,   1,   1,   1,   1,   1,   1,   1],
		[   1,   1,   1,   1,   1,   1,   1,   1,   1,   1,   1,   1,   1,   1,   1,   1,   1,   1,   1,   1],
		[   1,   1,   1,   1,   1,   1,   1,   1,   1,   1,   1,   1,   1,   1,   1,   1,   1,   1,   1,   1],
		[   1,   1,   1,   1,   1,   1,   1,   1,   1,   1,   1,   1,   1,   1,   1,   1,   1,   1,   1,   1],
		[   1,   1,   1,   1,   1,   1,   1,   1,   1,   1,   1,   1,   1,   1,   1,   1,   1,   1,   1,   1],
		[   1,   1,   1,   1,   1,   1,   1,   1,   1,   1,   1,   1,   1,   1,   1,   1,   1,   1,   1,   1],
		[   1,   1,   1,   1,   1,   1,   1,   1,   1,   1,   1,   1,   1,   1,   1,   1,   1,   1,   1,   1],
		[   1,   1,   1,   1,   1,   1,   1,   1,   1,   1,   1,   1,   1,   1,   1,   1,   1,   1,   1,   1],
		[   1,   1,   1,   1,   1,   1,   1,   1,   1,   1,   1,   1,   1,   1,   1,   1,   1,   1,   1,   1],
		[   1,   1,   1,   1,   1,   1,   1,   1,   1,   1,   1,   1,   1,   1,   1,   1,   1,   1,   1,   1],
		[   1,   1,   1,   1,   1,   1,   1,   1,   1,   1,   1,   1,   1,   1,   1,   1,   1,   1,   1,   1],
		[   1,   1,   1,   1,   1,   1,   1,   1,   1,   1,   1,   1,   1,   1,   1,   1,   1,   1,   1,   1],
		[   1,   1,   1,   1,   1,   1,   1,   1,   1,   1,   1,   1,   1,   1,   1,   1,   1,   1,   1,   1],
		[   1,   1,   1,   1,   1,   1,   1,   1,   1,   1,   1,   1,   1,   1,   1,   1,   1,   1,   1,   1],
		[   1,   1,   1,   1,   1,   1,   1,   1,   1,   1,   1,   1,   1,   1,   1,   1,   1,   1,   1,   1]
	],
	"foreground": [
		[  93, 109, 108, 109, 108, 109, 108, 109, 108, 109, 108, 109, 108, 109, 108, 109, 108, 109, 108, 109],
		[ 109,  39,  38,  39,  38,  39,  38,  39,  38,  39,  38,  39,  38,  39,  38,  39,  38,  39,  38,  93],
		[  93,  23, 137, 189, 190, 191, 137,   0,   0, 137,   0,   0,   0, 137, 166, 167, 168,   0,  22, 109],
		[ 109,  39,   0, 205, 206, 207,   0, 137,   0,   0,   0,   0, 137,   0, 182, 183, 184, 137,  38,  93],
		[  93,  23,   0, 137,   0,   0,   0,   0, 137,   0,   0,   0,   0,   0, 137,   0, 137,   0,  22, 109],
		[ 109,  39, 121, 121, 121, 121, 121, 121,   0,   0, 137,   0, 121, 121, 121, 121, 121, 121,  38,  93],
		[  93,  23,   0, 137,   0, 145,   0, 221,   0, 137,   0,   0, 221,   0, 145, 137,   0,   0,  22, 109],
		[ 109,  39, 137,   0,   0,   0, 122,   0, 122,   0,   0, 122,   0, 122,   0,   0,   0, 137,  38,  93],
		[  93,  23,   0,   0, 137, 221,   0, 137,   0, 221, 221,   0, 137,   0, 221,   0,   0,   0,  22, 109],
		[ 109,  39,   0,   0,   0, 122, 138,   0,   0,   0,   0,   0,   0, 138, 122,   0, 137,   0,  38,  93],
		[  93,  23,   0, 137,   0, 221, 137,   0,   0,   0,   0,   0,   0, 137, 221,   0,   0,   0,  22, 109],
		[ 109,  39,   0,   0,   0,   0, 122, 137,   0,   0,   0,   0, 137, 122,   0,   0,   0,   0,  38,  93],
		[  93,  23,   0,   0, 137,   0, 137, 221, 137,   0,   0, 137, 221,   0,   0,   0, 137,   0,  22, 109],
		[ 109,  39, 137,   0, 137, 146,   0,   0, 122, 137, 137, 122,   0, 137, 146,   0,   0, 137,  38,  93],
		[  93,  23,   0,   0,   0, 145,   0,   0,   0, 221, 221,   0,   0,   0, 145,   0,   0,   0,  22, 109],
		[ 109,  39,   0,   0,   0, 137,   0, 137,   0,   0,   0, 137,   0,   0, 137,   0, 137,   0,  38,  93],
		[  93,  23, 137, 243,   0,   0, 137,   0,   0,   0,   0,   0, 137,   0,   0,   0,  74,  75,  22, 109],
		[  38,  39, 121, 121, 121, 121, 121, 121,   0,   0, 137,   0, 121, 121, 121, 121, 121, 121,  38,  39],
		[ 234, 234, 234, 234, 234, 234, 234, 234, 186,   0,   0, 187, 234, 234, 234, 234, 234, 234, 234, 234],
		[  22,  23,  22,  23,  22,  23,  22,  23, 217,   0,   0, 219,  22,  23,  22,  23,  22,  23,  22,  23]
	],
	"collisions": [
		[   1,   1,   1,   1,   1,   1,   1,   1,   1,   1,   1,   1,   1,   1,   1,   1,   1,   1,   1,   1],
		[   1,   1,   1,   1,   1,   1,   1,   1,   1,   1,   1,   1,   1,   1,   1,   1,   1,   1,   1,   1],
		[   1,   1,   0,   0,   0,   0,   0,   0,   0,   0,   0,   0,   0,   0,   0,   0,   0,   0,   1,   1],
		[   1,   1,   0,   0,   0,   0,   0,   0,   0,   0,   0,   0,   0,   0,   0,   0,   0,   0,   1,   1],
		[   1,   1,   0,   0,   0,   0,   0,   0,   0,   0,   0,   0,   0,   0,   0,   0,   0,   0,   1,   1],
		[   1,   1,   1,   1,   1,   1,   1,   1,   0,   0,   0,   0,   1,   1,   1,   1,   1,   1,   1,   1],
		[   1,   1,   0,   0,   0,   0,   0,   0,   0,   0,   0,   0,   0,   0,   0,   0,   0,   0,   1,   1],
		[   1,   1,   0,   0,   0,   0,   1,   0,   0,   0,   0,   0,   0,   1,   0,   0,   0,   0,   1,   1],
		[   1,   1,   0,   0,   0,   0,   0,   0,   0,   0,   0,   0,   0,   0,   0,   0,   0,   0,   1,   1],
		[   1,   1,   0,   0,   0,   1,   0,   0,   0,   0,   0,   0,   0,   0,   1,   0,   0,   0,   1,   1],
		[   1,   1,   0,   0,   0,   0,   0,   0,   0,   0,   0,   0,   0,   0,   0,   0,   0,   0,   1,   1],
		[   1,   1,   0,   0,   0,   0,   1,   0,   0,   0,   0,   0,   0,   1,   0,   0,   0,   0,   1,   1],
		[   1,   1,   0,   0,   0,   0,   0,   0,   0,   0,   0,   0,   0,   0,   0,   0,   0,   0,   1,   1],
		[   1,   1,   0,   0,   0,   0,   0,   0,   1,   0,   0,   1,   0,   0,   0,   0,   0,   0,   1,   1],
		[   1,   1,   0,   0,   0,   0,   0,   0,   0,   0,   0,   0,   0,   0,   0,   0,   0,   0,   1,   1],
		[   1,   1,   0,   0,   0,   0,   0,   0,   0,   0,   0,   0,   0,   0,   0,   0,   0,   0,   1,   1],
		[   1,   1,   0,   1,   0,   0,   0,   0,   0,   0,   0,   0,   0,   0,   0,   0,   1,   1,   1,   1],
		[   1,   1,   1,   1,   1,   1,   1,   1,   0,   0,   0,   0,   1,   1,   1,   1,   1,   1,   1,   1],
		[   1,   1,   1,   1,   1,   1,   1,   1,   1,   0,   0,   1,   1,   1,   1,   1,   1,   1,   1,   1],
		[   1,   1,   1,   1,   1,   1,   1,   1,   1,   0,   0,   1,   1,   1,   1,   1,   1,   1,   1,   1]
	],
	"npcs": [
		"config/map/MysteriousForestNorth/instructions/npc/JP.json",
		"config/map/MysteriousForestNorth/instructions/npc/Fairy-1.json",
		"config/map/MysteriousForestNorth/instructions/npc/Fairy-2.json",
		"config/map/MysteriousForestNorth/instructions/npc/Fairy-3.json",
		"config/map/MysteriousForestNorth/instructions/npc/Fairy-4.json",
		"config/map/MysteriousForestNorth/instructions/npc/Fairy-5.json",
		"config/map/MysteriousForestNorth/instructions/npc/Fairy-6.json"
	],
	"signposts": [
		"config/map/MysteriousForestNorth/instructions/obj/Stone-1.json",
		"config/map/MysteriousForestNorth/instructions/obj/Stone-2.json",
		"config/map/MysteriousForestNorth/instructions/obj/Stone-3.json",
		"config/map/MysteriousForestNorth/instructions/obj/Stone-4.json",
		"config/map/MysteriousForestNorth/instructions/obj/Barrel-1.json",
		"config/map/MysteriousForestNorth/instructions/obj/Barrel-2.json"
	],
	"sprites": [
		{
			"name": "grass",
			"path": "gfx/tile/grass.png",
			"multiSprite": false,
			"width": 0,
			"height": 0
		},
		{
			"name": "props",
			"path": "gfx/tile/props.png",
			"multiSprite": true,
			"width": 64,
			"height": 64
		},
		{
			"name": "stone-2",
			"path": "gfx/tile/stone-2.png",
			"multiSprite": false,
			"width": 0,
			"height": 0
		},
		{
			"name": "barrel",
			"path": "gfx/tile/barrel.png",
			"multiSprite": false,
			"width": 0,
			"height": 0
		},

		
		{
			"name": "jp",
			"path": "gfx/char/main-1.png",
			"multiSprite": true,
			"width": 64,
			"height": 64
		},
		{
			"name": "fairy",
			"path": "gfx/char/fairy.png",
			"multiSprite": false,
			"width": 0,
			"height": 0
		},
		{
			"name": "fairy2",
			"path": "gfx/char/fairy-2.png",
			"multiSprite": false,
			"width": 0,
			"height": 0
		},
		{
			"name": "fairy-s1",
			"path": "gfx/char/fairy-1.png",
			"multiSprite": true,
			"width": 64,
			"height": 64
		},
		{
			"name": "fairy-s2",
			"path": "gfx/char/fairy-2.png",
			"multiSprite": true,
			"width": 64,
			"height": 64
		}
	]
}