{
	"name": "Mysterious Forest",
	"startX": 640,
	"startY": 1088,
	"startFacing": "up",
	"width": 1280,
	"height": 1280,
	"columns": 20,
	"rows": 20,
	"background": [
		[   1,   1,   1,   1,   1,   1,   1,   1,   1,   1,   1,   1,   1,   1,   1,   1,   1,   1,   1,   1],
		[   1,   1,   1,   1,   1,   1,   1,   1,   1,   1,   1,   1,   1,   1,   1,   1,   1,   1,   1,   1],
		[   1,   1,   1,   1,   1,   1,   1,   1,   1,   1,   1,   1,   1,   1,   1,   1,   1,   1,   1,   1],
		[   1,   1,   1,   1,   1,   1,   1,   1,   1,   1,   1,   1,   1,   1,   1,   1,   1,   1,   1,   1],
		[   1,   1,   1,   1,   1,   1,   1,   1,   1,   1,   1,   1,   1,   1,   1,   1,   1,   1,   1,   1],
		[   1,   1,   1,   1,   1,   1,   1,   1,   1,   1,   1,   1,   1,   1,   1,   1,   1,   1,   1,   1],
		[   1,   1,   1,   1,   1,   1,   1,   1,   1,   1,   1,   1,   1,   1,   1,   1,   1,   1,   1,   1],
		[   1,   1,   1,   1,   1,   1,   1,   1,   1,   1,   1,   1,   1,   1,   1,   1,   1,   1,   1,   1],
		[   1,   1,   1,   1,   1,   1,   1,   1,   1,   1,   1,   1,   1,   1,   1,   1,   1,   1,   1,   1],
		[   1,   1,   1,   1,   1,   1,   1,   1,   1,   1,   1,   1,   1,   1,   1,   1,   1,   1,   1,   1],
		[   1,   1,   1,   1,   1,   1,   1,   1,   1,   1,   1,   1,   1,   1,   1,   1,   1,   1,   1,   1],
		[   1,   1,   1,   1,   1,   1,   1,   1,   1,   1,   1,   1,   1,   1,   1,   1,   1,   1,   1,   1],
		[   1,   1,   1,   1,   1,   1,   1,   1,   1,   1,   1,   1,   1,   1,   1,   1,   1,   1,   1,   1],
		[   1,   1,   1,   1,   1,   1,   1,   1,   1,   1,   1,   1,   1,   1,   1,   1,   1,   1,   1,   1],
		[   1,   1,   1,   1,   1,   1,   1,   1,   1,   1,   1,   1,   1,   1,   1,   1,   1,   1,   1,   1],
		[   1,   1,   1,   1,   1,   1,   1,   1,   1,   1,   1,   1,   1,   1,   1,   1,   1,   1,   1,   1],
		[   1,   1,   1,   1,   1,   1,   1,   1,   1,   1,   1,   1,   1,   1,   1,   1,   1,   1,   1,   1],
		[   1,   1,   1,   1,   1,   1,   1,   1,   1,   1,   1,   1,   1,   1,   1,   1,   1,   1,   1,   1],
		[   1,   1,   1,   1,   1,   1,   1,   1,   1,   1,   1,   1,   1,   1,   1,   1,   1,   1,   1,   1],
		[   1,   1,   1,   1,   1,   1,   1,   1,   1,   1,   1,   1,   1,   1,   1,   1,   1,   1,   1,   1]
	],
	"foreground": [
		[ 109, 108, 109, 108, 109, 108, 109,  39, 217, 137,   0, 219,  38, 108, 109, 108, 109, 108, 109, 108],
		[  93, 109,  39,  38,  39,  38,  39, 122, 217,   0, 137, 219, 122,  38,  39,  38,  39,  38,  93,  92],
		[ 109,  39,   0,   0, 137,   0, 137,   0, 233, 234, 250, 235,   0, 137,   0, 137,   0,   0,  38, 108],
		[  93,  23, 137,   0,  74,  75,   0, 137,   0,   0,   0,   0, 137,   0, 243,   0,   0, 137,  22,  92],
		[ 109,  39,   0, 137,   0,   0,   0,   0,   0,   0,   0,   0,   0,   0,   0,   0, 137,   0,  38, 108],
		[  93,  23,   0,   0, 138, 221, 221, 138,   0,   0, 137,   0, 138, 221, 221, 138,   0,   0,  22,  92],
		[ 109,  39,   0,   0, 138, 221, 221, 138,   0, 137,   0,   0, 138, 221, 221, 138,   0,   0,  38, 108],
		[  93,  23, 137,   0, 138, 221, 221, 138,   0,   0, 137,   0, 138, 221, 221, 138,   0, 137,  22,  92],
		[ 109,  39,   0,   0, 138, 221, 221, 138,   0,   0,   0,   0, 138, 221, 221, 138,   0,   0,  38, 108],
		[  93,  23,   0,   0,   0,   0,   0,   0, 137,   0,   0, 137,   0,   0,   0,   0,   0,   0,  22,  92],
		[ 109,  39, 137,   0,   0, 137,   0, 137,   0,   0,   0,   0, 137,   0, 137,   0,   0, 137,  38, 108],
		[  93,  23, 121, 121, 121, 121, 121, 121, 121,   0,   0, 121, 121, 121, 121, 121, 121, 121,  22,  92],
		[ 109,  39,   0,   0,   0,   0,   0,   0, 121, 137,   0, 121,   0,   0,   0,   0,   0,   0,  38, 108],
		[  93,  23, 137,   0, 137, 122, 122, 137, 121,   0,   0, 121, 137, 122, 122, 137,   0, 137,  22,  92],
		[ 109,  39,   0,   0, 137, 122, 122, 137, 121,   0,   0, 121, 137, 122, 122, 137,   0,   0,  38, 108],
		[  93,  23,   0,   0,   0, 137,   0,   0, 121,   0, 137, 121,   0,   0, 137,   0,   0,   0,  22,  92],
		[ 109,  39, 137,   0,   0,   0,   0,   0,   0,   0,   0,   0,   0, 137,   0,   0,   0, 137,  38, 108],
		[  93,  23,   0,   0, 137,   0, 137,   0,   0, 137,   0,   0, 137,   0,   0, 137,   0,   0,  22,  92],
		[ 109, 108,  23,  22,  23,  22,  23,  22,  23,   0,   0,  22,  23,  22,  23,  22,  23,  22,  92, 108],
		[  93,  92,  93,  92,  93,  92,  93,  92,  39,   0,   0,  38,  93,  92,  93,  92,  93,  92,  93,  92]
	],
	"collisions": [
		[   1,   1,   1,   1,   1,   1,   1,   1,   1,   0,   0,   1,   1,   1,   1,   1,   1,   1,   1,   1],
		[   1,   1,   1,   1,   1,   1,   1,   1,   1,   0,   0,   1,   1,   1,   1,   1,   1,   1,   1,   1],
		[   1,   1,   0,   0,   0,   0,   0,   0,   1,   1,   0,   1,   0,   0,   0,   0,   0,   0,   1,   1],
		[   1,   1,   0,   0,   1,   1,   0,   0,   0,   0,   0,   0,   0,   0,   1,   0,   0,   0,   1,   1],
		[   1,   1,   0,   0,   0,   0,   0,   0,   0,   0,   0,   0,   0,   0,   0,   0,   0,   0,   1,   1],
		[   1,   1,   0,   0,   1,   1,   1,   1,   0,   0,   0,   0,   1,   1,   1,   1,   0,   0,   1,   1],
		[   1,   1,   0,   0,   1,   1,   1,   1,   0,   0,   0,   0,   1,   1,   1,   1,   0,   0,   1,   1],
		[   1,   1,   0,   0,   1,   1,   1,   1,   0,   0,   0,   0,   1,   1,   1,   1,   0,   0,   1,   1],
		[   1,   1,   0,   0,   1,   1,   1,   1,   0,   0,   0,   0,   1,   1,   1,   1,   0,   0,   1,   1],
		[   1,   1,   0,   0,   0,   0,   0,   0,   0,   0,   0,   0,   0,   0,   0,   0,   0,   0,   1,   1],
		[   1,   1,   0,   0,   0,   0,   0,   0,   0,   0,   0,   0,   0,   0,   0,   0,   0,   0,   1,   1],
		[   1,   1,   1,   1,   1,   1,   1,   1,   1,   0,   0,   1,   1,   1,   1,   1,   1,   1,   1,   1],
		[   1,   1,   0,   0,   0,   0,   0,   0,   1,   0,   0,   1,   0,   0,   0,   0,   0,   0,   1,   1],
		[   1,   1,   0,   0,   0,   1,   1,   0,   1,   0,   0,   1,   0,   1,   1,   0,   0,   0,   1,   1],
		[   1,   1,   0,   0,   0,   1,   1,   0,   1,   0,   0,   1,   0,   1,   1,   0,   0,   0,   1,   1],
		[   1,   1,   0,   0,   0,   0,   0,   0,   1,   0,   0,   1,   0,   0,   0,   0,   0,   0,   1,   1],
		[   1,   1,   0,   0,   0,   0,   0,   0,   0,   0,   0,   0,   0,   0,   0,   0,   0,   0,   1,   1],
		[   1,   1,   0,   0,   0,   0,   0,   0,   0,   0,   0,   0,   0,   0,   0,   0,   0,   0,   1,   1],
		[   1,   1,   1,   1,   1,   1,   1,   1,   1,   0,   0,   1,   1,   1,   1,   1,   1,   1,   1,   1],
		[   1,   1,   1,   1,   1,   1,   1,   1,   1,   0,   0,   1,   1,   1,   1,   1,   1,   1,   1,   1]
	],
	"npcs": [
		"config/map/MysteriousForest/instructions/npc/Rapthalia.json",
		"config/map/MysteriousForest/instructions/npc/Leafa.json",
		"config/map/MysteriousForest/instructions/npc/Skeleton.json"
	],
	"signposts": [
		"config/map/MysteriousForest/instructions/obj/Pillar-1.json",
		"config/map/MysteriousForest/instructions/obj/Pillar-2.json",
		"config/map/MysteriousForest/instructions/obj/Sign.json"
	],
	"sprites": [
		{
			"name": "grass",
			"path": "gfx/tile/grass.png",
			"multiSprite": false,
			"width": 0,
			"height": 0
		},
		{
			"name": "props",
			"path": "gfx/tile/props.png",
			"multiSprite": true,
			"width": 64,
			"height": 64
		},
		{
			"name": "stone",
			"path": "gfx/tile/stone.png",
			"multiSprite": false,
			"width": 0,
			"height": 0
		},
		{
			"name": "sign",
			"path": "gfx/tile/sign.png",
			"multiSprite": false,
			"width": 0,
			"height": 0
		},
		


		
		
		{
			"name": "demi",
			"path": "gfx/char/demi.png",
			"multiSprite": false,
			"width": 0,
			"height": 0
		},
		{
			"name": "fairy",
			"path": "gfx/char/fairy.png",
			"multiSprite": false,
			"width": 0,
			"height": 0
		},
		{
			"name": "skeleton",
			"path": "gfx/char/skeleton.png",
			"multiSprite": true,
			"width": 64,
			"height": 64
		}
	]
}